___________________________________
|                      .......    |
| ################## # ########## |
|..................              &|
|  #### ################          |
|     # #  .  .....               |
|     # ################      #  ##
|  ... .      $  .......      # @ #
|_____________________________#####